(A)
Anta : dia (LK)
Amba : pasar
Ake, ei : air
Api, putung : api
Ai : kaki
Ati : hati
Ana : anak
Apo : paman
Ana seriken : anak pertama, anak sulung
Aku : aku, kita
Ani : belum
Anuhodo : juragan
Atasuan : utusan
Ata, atta : orang, manusia
Ata tungu : orang pandai : ata mjaek, pintar, cerdas
Ata pamusu : bajak, orang membajak sawah: ata pamusu bangga
Atu : untung
Artina, mbiseri : dibelakang
Ama : bapak
Aku : goa, gua
Aka : akar
Angar : kapuk
Angelak : buka
Arwawa, Mbiwaw : bawah, dibawah
Angar : kapuk, kapas
apu : kapur
Ampa cola : bayar
Ape : apa
Atta, enda : orang
Aun : arti, pahami, memahami
Assu : anjing
Aho : lambat, lamban
Atengamok : ngamuk, amuk ; orang mengamuk
Aruna : nanas
Angin : angin
Awak : langit

(B)

Bua : angkat
Barisa : lada
Be : mana
Baka : luka
Bako : topi
Balaju : semangka
Banga, rammeng : ladang
Blanja : belanja
Baba : bisu, gagap, gugup
Bau : kerbau
Balumbang : ombak, gelombang
Barat : barat
Bra : habis
Bea : tunggu
Bae, mbae : pecah
Belu : lubang
Borot : kasar
Bonger : pundak
bore : pesta
bura : putih
Beke : kasih, memberi
Benteng : benteng
Basa : malam
Belia : mahal
Bei : monyet
Bara : bersih
Buso’o : mencopot
Bungu : kening
Bale, sembali, pali : balik, pulang, kembali
Badara : bebek
Bulan, wulok : bulan
Bangia : hitung, menghitung
Begitu : kasunang
Binca : belah
Binti : bernapas
Bolok : bintang
Bani, bane, mbane : banyak
Bolang : buang
Binatang : binatang
Bangga : sawah
Babini, bini : perempuan, istri
Bapa : ayah
Bango : bangau
Beo : burung beo
Beki : boleh
Bawa : bawa
Brei : bangun
Bulu cumi : kumis
Bobo barang : kunang-kunang
Bore/boro : ramai

(C)

Cawi : mampir
Cura : bawang
Cango : mencabut
Cangker : mangkuk
Cofi : sapu
Cunga : goring
Cembe : erat
Candu : muntah
Cio : nangis, menangis
Condo : salin, menyalin
Capi : sapi, lembu
Compa : sampai
Cara : enak, lezat, nikmat
Compa : datang

(D)

Darua : dua
Dewa : putra, putri
Dara, raa : darah
Dussak : Amarah
Deke : halus
Duluku : lipat
Derisen : mula, mulai
Darong : bisa
Desi : panjang
Dodo : berat
Dipok : potong, memotong
Dulok : gulung
Deke, ndeke : kecil
Delu wudu : penis
Daraki : buruk, kurang baik, kurang bagus
Daran : burung dara
Dagangan : dagang, jualan
Do’u : jauh
Deni : mampir, singgah, dekat
Daja : arah
Dusse : marah
Duam puluh isa : dua puluh satu (21)
Durian : durian
Dota : dinding
Dalok : dalam, kedalaman
Datang : rampas, merampas
Dalima : delima

(E)

Eloh : siang hari
Ena : ada
Empo tanga, Mpotak : lihat
Entok, kayan, ndok : duduk
Enbai : bayam
Erri : pasir
Epa : empat
Ese : laki-laki
Erum : kawan, teman
Ei, ake : air
Empon : sewa
Endok, endo, kampong : kampung, Desa, negara
Enda, atta : orang
Enggolok : kumpul, berkumpul

(F)

Fare : padi

(G)

Giak : bikin, buat, membuat
Gelonggor : longgar
Gunting : gunting
Glep : guntur
Gongongon : gonggongan
Gara : gagak
Gojo : geli
Grampu : peluk, memeluk
Gawe, Pegewa, krawe : kerja, bekerja
Gawen : sebab
Galupa : lupa
Gambir : gambir
Golo : guling

(H)

Hebo : bohong
Hito, kito : disana, sana
Ho : iya (kasar)
Hamboeng : dari
Hukur : ukur

(I)

Ina, nina : ibu
Ina cili : ibu tiri
Inatua : nenek, matua : kakek
Iu : rasa
Ina besusu : penyusu, mensusu, menyusu
Iko : tali
Isi : gigi
Indu : hutan
Ikon: ekor
Isen : biji
Imba : gambar, menggambar

(J)

Ja : sekarang
Jampa : pelihara
Seng: uang, keping
Jembatan : jembatan
Jambu : jambu
Jaran : kuda
Jati : pohon jati
Jaga : jaga, menjaga
Jagoang : jagung
Jompa : dating
Jengkelle : melebih, melebihkan, berlebih

 (K)

Kaja : malu
kuna : ikan
Kambosse : bagaimana
kune : kendati
kalubu : abu
kadodo : dodol
kalu : bayangan
kula : jamur
kutak : hutang
kua : di (kua uma : di rumah)
Kapa : kapas
Kapoa : kecebong
Kranjing : keranjang
Kawanan : kanan
Katumbar : ketumbar
Karome :nakal
Kaban : gabus
Ketotok : kaget
Kabu’el : pancoran
Karassa : karang, koral
Karuki : keptiting
Keka : burung kakaktua
Kelakan : pancar
Kaju : kayu
Sugi : kaya
Kuku : kuku
Kasumba : kesumba
Kuwu : pondok, gubuk
Koson : tidak tau
Katuweng : mengantuk, ngantuk
Karong : karung
Kanci : kunci
Kodo : kendor
Karaun {b. bima : lede’} : gadung
Ka’e : keras
Kandi : kendi, lumpang (B. bima : kandei), encok (b. bima : nocu)
Kartas : kertas
Kussu : kaku
Kentari : bersedia
Kampurot : pepaya
Kananga : kenanga (bunga)
Kanari : kenari (bunga)
Kurung : kandang
Kune : kendati
Kutu : kutu
Kapal : kapal
Kalambu : kelambu
Kabol : bisul
Kalakati : rahang
Kapoa : selamat datang
Kome, komi : engkau, kamu
Kuna : ikan
Krame : jari
( ibu jari : inan rima
Telunjuk : lima turu
Jari tengah : tonga
Jari manis : mina
Kelingking : deke )
Komba : belang (warna)
Kune anta : tidak usah
Kumang : makan
Kota : kota
Kiris : keris
Kira : rindu, mengingat
Kruki : kepiting
Kasipau : miskin
Kemmi : kemiri
Kamuning : kayu kemuni
Kamojo : hisap
Kamboi : kemana
Kambo’eng : (di)/(ke) mana
(wanon kambo’eng : dari mana)
Kaweken : kiri
Kaji : kayu
Kaduru : roboh
Kedong : kurus
Kolen : merinding
Kitab : kitab
Koro’an : al-Qur’an
Kikin : kikir (alat)
Kitab : kitab
Koka : nasi
Kawoi : pancing, memancing, (b. bima : hawi)
Kukos : kukus
Kiwa : daging
Kuni : kunyit
Kojo : geli 

(L)

Lima : lima
Lumor, lumdur : dingin
Luro, liro : banting
Lino : banjir
Lassa : langsat
Lako : pergi
Lako kamboi : pergi kemana
Lako letek : pergi cepat
Lasa : lapang, luas
Loli : belut
Lepak : kodok
Lissu : mabuk
Lontak : lompat
Lindor : gempa
Lalu : lalat
Lerong : keliling
Letta : bubur
Lettek : roti
Leon : lancip
Loka : periuk
Lembo : perut
Lolo : pantat
Loke, roco : kupas
Lua : lebar
Lea : nyala,menyala
Lummong : rendam
Lilik, ilo : lilin
Lompokko : lepas
Lerong : keleling
Lo’en : murah
Loki : kulit
Lundok : gelap
Lolen : kosong
Lio lao : pelan-pelan
Lingong : bingung
Latta, wiwen : pinggir, pinggiran, galangan
Lata : ubur-ubur
Lombon : baju
Langkalo : kaca, cermin
Luju : keluar
Linti : geger, rusuh
Lopi, sampan : perahu, sampan
Lue : ujung
Lenu : licin
Lorong : kebun
Loro : keropos
Lepak : katak
Lunca : pulau
Lande : pinang (buah/pohon)
Luru : bantal
Telupo : lipan
Lapak : laku
Limbi : belimbing bulu
Lampa : tikar, sandal
Lenape : mengapa
Lojo : malas
Langa-langa : laju
Lawa : nyanyi, menyanyi, mengaji
Lappa: lapar
Linang : harta
Loja : layar, berlayar
Limbok : lumpur
Letek : cepat, lekas
Lukok : dapur
Lasa : bidara
Lio mata : pusing
Lolok : dubur, pantat

 (M)

Mardeka : merdeka
Metiki, Mandu: tidur
Manu : ayam
Mate, nati : mati, meninggal
Matadai : matahari
Mantri : mentri
Manu ranggo : ayam jantan
Manu wine : ayam betina
Mawira : putih
Mango’on : darat, daratan
Muti : bicara
Monde : bagi
Malu : layu
Moro : obat
Morong : (warna) hijau
Manggo : kering
Morowisel : peluru
Mangi : hangus
Maweken : gemuk
Meah : merah
Mombi : mangkudu
Mitung, mutok, Mulong : hitam
Mapia : bagus
Mpapa : potong
Mondok : malam
Mali : tertawa
Mai : kemari, kesini
Muto : benang
Mapu : lemah
Mbe : kambing
Massi : kasihan
Mpondo : takut
Muti : bahasa
Mesa, Mesan : diri, sendiri, sendirian
Meu : terserah
Mbau : kerbau
Mpele, tungu : pintar, pandai
Manuk darodo : burung
Mpotak, empo tanga  : lihat
Mancu : sayur
Maa : besar
Mina : manis
Mone : laki-laki
Meti : laut
Mati : bunuh
Mo’u : jatuh
Mangge : asam
Mudu : kebakaran
Munen : sembunyi
Mpowi : rebus
Mpoja, poja : berak
Mawu-Allah : Tuhan, Allah
Mapuru :seratus
Mba’e : pecah
Maca : cangkul, mencangkul
Mpali : pulang
Menyahut : sahut menyahut
Mene, Menek : jangan
Mplai, palei : lari, berlari
Mbara, pabara : bersihkan, membersihkan
Mance, odes : rajin
Mangga : jangkar
Mbeli : beli
Mumong : ingus, flu
Monce : tanam
Mano : pakai
Muti : kata
Manjang : menjangan, rusa
Mata : mata
   (wuton : kemaluan laki-laki
     Sawe : kemaluan wanita)
Mati : mampus
Mbolang : buang
Mberese : diatas
Mayit : bangkai
Moda : gampang, mudah
Mango woko : haus, dahaga
Malembu : hamil, bunting
Mawa : jinak
Mbi wawa, arwawa : dibawah
Mata : mata
Mangusta : manggis

Markani : perkakas

Mori : hidup

Monca : kuning

Muti : jeruk

Mono : main, bermain

Mondek : baik

Mbi lolol : didalam

Mbiseri, artina : dibelakang

(N)

Nati, mate : mati

Nassa : budak

Niko : ikat

Nela : lidah

Neo : ringan, enteng

Ngenimpe : mimpi

Ngaka’a : raba, meraba

Nga : makan

Ngeri : mirip

Ngino : minum

Ngale : ambil, meng-ambil

Ngawu : keringat

Ntowok : diam

Nagara : negri

Ngeri : pantai

Ndupa : dupa

Ne : bening, hening

Nyai : nyai

Nyonya : nyonya

Nona : nona

Nana : getah

Ngeong : kucing

Ngarakan : nama, namanya

Ntendi, tendi : berdiri

Ngonang : bermain, ata ngona : orang bermain

Ndiu : mandi

Nika : kawin, menikah, nikah

Ngumba : gendong

Ngusi : kejar, berburu

Ngak : makan

Ngo’e : panggil

Nguse : mau

Nong : enam

Ngutong : bertanya

Ncaru : ikut

Ntondak : turun

Ne’eng : naik

Ngondok : maling, pencuri

Ngewen : gantung

Ngelu : dapat

Ngawang : kasih tau

Ncango : goreng

Ntau : simpan

Ngutak : pinjam

Nenti : pegang, memegang

Ngunpo, nggina : habis

Nao : aren

Ngaka’a : dam, bendungan

Ndalo, dalo : jalan

Ndai : besok

Ngaye : malu

Ngante : pegang

Ngordong : bangsat, brengsek, bejat

Ndeke, deke : kecil

Ngoku : pungut, memungut

Ncua : suruh

Ngilu : kecut, ngilu

Ngurini, nuni : bilang, berkata, kasih tau

Ngeda : basah

Ngi : gigi

Ngusi : usir

Nipah : nipah

Ngawi : gigit

Ngilok : gila

Ngumba : gendong

Ntasa : matang (buah)

Ngalep : lambai, melambai

Ngawi, oi kerya : keringat

Ngupok : genggam

Nasam : saya

Ndalo : rawa-rawa

Nambe : hilang

Ngika : rusak

Ngallok : mendidih

Nginong : minum

Niki : kalong, kelelawar

Ne’eng : panjat

Nina, ina : ibu

Ngalek, ngale : ambil

Ngkai : kami

Ndadi : jadi

Nika iu : pingsan

No : lagi

Nisi : penuh

Nenton : menantu

Nemo : terbang

Ngondok : curi

Ngi’I : gusi

Ngoso : gosok

Ngarak : pikir, melahirkan ( kena nako : berfikir, pikiran)

Ngiu, ncio : nangis, menangis

Nali : tertawa

Ngiro : hidung

Ngoka : masak

Ncuku : panggang

(O)

Oret : datu, maha raja (sangaji)

Oro : pintu, jalan, dengan {oro sei? : dengan siapa}

Ou : bambu

Ongen : lidi

O’or : embun

Onen : guna, gunakan

Ono : lama ( sambosi ono : berapa lama)

Omet : lintah

Omes mea : cengar-cengir

 (P)

Paduka : raja, ratu

Padak : asin

Pa : tanduk

Pau : mangga

Palana : gegabah

Putung, api : api

Porek : lebah

Pani : sayap

Peu : pijit

Puasa  : puasa

Popekon : rebung bambu

Pambua : pindah

Penabur : kecamba

Poter : putar, erat-erat

Pusa’at : berakhir

Papak : papan, papan kayu

Poja, mpoja : berak

Parisa : periksa, memeriksa

Prenta : perintah

Pertama : siriken

Percaya : percaya

Punti : pisang

Pek : perabot

Poe : garuk

Pusaka : pusaka

Puter : pusar

Puso : pusat

Pilih : pilih

Piler : rata, sejajar

Peu : pijat, memijat

Perde, nguku : pendek

Pires : kapan

Pokon : pohon

mpoka : patah

Panjar : panjar

Paron : gambong, gembong (alat music)

Pamango’o : jemur, jemuran, menjemur

Palinga, Lunga : dengar, mendengarkan

Panteng : gadai

Petu : burung perkutut

Poja : kotoran

Parrong : asap

Pawelek : jual

Potok : udang

Pacompa : sampaikan

Pelepu : tarik

Pakumu : selimut

Pessu, kenta : kentut

Panghulu : penghulu

Paroh : patuk, mematuk

Patut : patut, pantas

Piso : buta

Pinggung : pinggul

Poda : pedang

Pandu : obor

Pasang : pasang

Pai : pahit

Panjong : payung

Pea, bea : nanti, tunggu

Pawuan : muat, muatan

Powe : masak

Pabua : mesti, harus

Panisi : isi, mengisi

Pangrai : ingat, mengingat

Parawi : binasa, musnah

Pau : mangga

Pronu : karat

Pangao : korek

Penabur : mimisan

Po’o, po : kepala

Pana : panah

Paku : paku

Pamor : pamor

Panah : panah

(ana) panah : anak panah

Pana : panas

Pundok : pandan

Pitu : tujuh

Pile : perampok, rampok, merampok

Paloja : belajar

Pakatu : kirim, mengirim

 (R)

Ranga : pagar

Reij : alang-alang

Rau, utana : tanah

Resse : atas, ulas, mengulas

Rara : pedas

Rencallak : salah

Rena : kurang

Rui : duri

Ralipa : diseberang

Rugi : rugi

Rata : rumput

Rua : rupa, tampang

Reseri : luar

Rengau : perang

Rapu : Rapat

Rante : rantai

Robo naru : labu air

Rincot : genap

Rene mondo : tidak baik, jelek

Rao : jarum

Rua : muka

Rate : kuburan

Rupiya : rupiah

Rokan : musim

Rammeng, banga : ladang

Rokon : daun

Ruwa : haluan

ruta : kacang

Ringgi : uang ringgit

Ruta : kedelai

Rere : baris, berbaris

Rau : bumi

Racon : racun

Rollor : bulat

 (S)

Sara, sarah : adat

Paloja, Senun: belajar, mengajar

Sara : adat

Salawat : sholawat

Sangungawan : kami

Sangu wungan : segala

Soa : jahat

Sabtu : sabtu

Sagu : sagu

Sene wine : berderap, menderap

Saworon : majang, memajang

Sebokon : jongkok

Sao : lawan, melawan

Sambua : satu

Pissi: sambal

Sawan, bini : istri

Sioh, siwa : Sembilan

Saribu, ribu : seribu, ribuan

Semuto : otak

Sakali : sekali

Selili : ketiak

Sedang : sedang

Selaka : perak

sanggilo : ikan gabus

Sabio : sedikit

Silen : ganti

Sandan : santan

Samu : mengikat rambut (perempuan)

Sei : siapa

Sempolo : perawan, gadis

Sugi : punya

Sudok : kencing

Serisin : gerimis

Sissi : karet

Santopa : putus

Sangeren : rusuk

Samba : ular sanca

Sida : benar, betul

Senawa : berhenti

Sangu : Dagu

Sawean : disebelah

Selatan : selatan

Sadanaba, rowa : arit, parit, selokan

Sebolok : sebentar

Sompon : lumpur

Sarta : dia

Sarang : sarang

Sungu wangan : memang, emang

Surunge : kelor

Sando : dukun, santet

Sedean, Lawe  : demam, sakit parah

Sembossi : berapa

Sama : sama, sama (juga)

Sia : garam

Sambole : palu, pemukul

Sepepe : misan

Selepe : ikat pinggang

Samuna : juga

Sala : bukan

Salindang : selendang

Sambole : pukul, hantam

Sampula : bodoh

Sepatu : sepatu

Selu : gelang

Sembola : pagi

Sembole : menyelimuti

Sewun : ompong

Sanca : parang

Semia : begini

Sigeleng : tanduk (rusa)

Sampola : bujang, lajang

Sandenge : sakit

Sanca : barang

Singai : hari (malam hari, siang hari)

Sangania : hari ini

 (T)

Taal : lontar (pohon)

Tiang : perut

Takiar :tangan

Tarau : jalu

Telor : telur

Tete : kena

Totonanga : muara, danau

Taruna : dulu

Tue : kerang

Tui : pisau

Taking : genit

Tore’en : punya

aku tore’en : Punya (saya/kita)

Tungu, mpele : pintar, cerdas, pandai

Tengapi : panggang, memanggang

Tonga po’on : uban

Treru : kalajengking

Temme/selompi : sarung

Tike : tokek

Tidu : meludah

Tu : lutut

Tao : ikan (nila)

Tete : kena

Tonga : nyamuk

Terutung : landak

Tolek : kuping

Tande : kenal

Tupa : kelapa

Tengere : miring

Tenda : terang, gemilang, cerah

Tinang : gunung

Tatelu : tiga

Teke : kecil

Topo’o wo : cukur,pangkas rambut, mencukur rambut

Tombu : masuk

Timba : mayat, bungkus

Tau mata : (seorang/seseorang) laki-laki

Tero : atap

Tunu : pasang surut

Talla : gong

Toto : mulut

Toto’on : mematuk

Tommon : dimuka, didepan, terdepan

Tanuna : dahulu

Tunu : bakar

Tempi : besi

Titi : rontok

Tengulu : gula

Tawar : penawar

(U)

Uta  : rambut

Urok : hujan

Ula : ulat

Uti : biawak

Uma : rumah

Uncong : pikul, memikul

Utara : utara

Umur : umur

Ua : urat

Uncong : pikul

Uwi : ubi jalar

Urekh : arang

Utana, rau : tanah

Upen : tas

 (W)

Wessu : kijang

Wawi : Babi

Watu : batu

Warang : kali

Wisel : senapan, senjata

Walu : delapan

Weki : badan

Weu : baru

Wolo niwa : madu

Wani : berani

Wante : rebus

Winga : piring

Wau : pohon beringin

Wiwen : minggir

Walo : biru

Watak : batang

Weli : beli

Welawa : pantun

wokon : leher

Wiwi : bibir

Waja : silet

Wewi : kipas

Wele : layang-layang, layangan

Walen : jujur

Wiwe meti : pesisir, pesisir pantai, pesisir laut

Wiwe : pesisir

Wulo : kasur

Wouk : uap

Wota : bunga

Wulok : bulan

Woe : bulu

Wai : busuk
Wu’e : rotan
Wota : pucuk bunga, kembang
Welen : harga
Wuntu : gondok
Wuan : buah
Wua : beras
Ware’en : separuh, sebahgian
Wuntuf : matang (nasi)